#################### 
#   # # #          # 
#      ###  #     O# 
#       #   #  #   # 
##  # #  # #       # 
#       #    #   ### 
#      # #  #      # 
##      #       ## # 
#    ### ### ## #  # 
#    #  #          #
# O               ## 
#       #          # 
#        # #       # 
#   #   #   #    # # 
#    #   #  #  #   # 
#  #    #      ## ## 
#     #  #    ##   # 
#     # # #          
# #  ##    #    #  # 
#################### 